##          B
## ######### 
## ######### 
## #   ##### 
##   # ##### 
#### # ##### 
A    #       